####################
#A.................#
#..................#
#..................#
#..................#
#..................#
#..................#
#..................#
#..................#
#.......&&&........#
#................../
#~~~....000........#
#.......^^^........#
#..................#
#..................#
#..................#
#..................#
#..................#
#..................#
#########/##########
